000000000000000000000000000000000000000000
003333333333333300003333310000000000000000
003444443444444300003444010003333333333300
003444443444444333333441110003000000000300
003443443444344344440441110003000222000300
003333333333333334440444010003000222000300
003222222222222334440000010003000222000300
003222222222222344440444010003000222000300
003222200002222333333444010003000000000300
003222200002222300003441110003333333333300
003222200002222300003444010000000030000000
003222222222222300003444010000000030000000
003222222222222300003000010000000030000000
003333333333333311111111111111111111111111
001000000000000100000000010000000000000000
001044400444400104444444010444444404444400
001334400444111104444444010444444404444400
001044400444400104144414010444414404414400
001000000000000100100010010000010000010000
001111111111111111111111111111111111111100
001333333100000000001000100000100103000100
001344443104440044401044140440104143440100
001344443104440044111044440440104443440100
001344433111440044401000000411100003411100
001344443104440044401044440440104443440100
001344443104440044401044140440104143440100
001333333100000000001000100000100103000100
001111111111111111111111111111111111111100
001000000001000030103000301000100003000100
001044444401044434143444341400104443440100
001044114401041434443414344400104444440100
001000110001001030003010300000100000000100
001111111111111111111111111111111111111100
001000000000000000001000000300000013333100
001044444444444444401000000300000013443100
001041111111441114401000000300000013443100
001041444441444414401333333333333313343100
001041111441111114401000000300000013443100
001044441444444444401000000300000013443100
001000001000000000001000000300000013333100
001111111111111111111111111111111111111100
000000000000000000000000000000000000000000